11,15,,,,,,,,,,,,,
1,1,1,1,1,1,1,1,1,1,1,1,1,1,1
1,300,1,11,1,0,0,312,1,1,0,0,0,316,1
1,0,1,0,0,0,1,1,1,1,1,1,1,1,1
1,0,1,1,1,0,0,311,1,1,0,0,0,317,1
1,0,0,0,1,0,1,1,1,1,1,1,1,1,1
1,1,1,0,1,0,0,313,1,1,0,0,0,0,1
1,0,0,0,1,0,1,1,1,1,1,1,0,0,1
1,0,1,1,1,0,0,314,1,1,0,0,0,0,1
1,0,1,0,0,0,1,1,1,1,1,1,0,0,1
1,0,0,0,1,0,0,315,1,1,0,0,0,301,1
1,1,1,1,1,1,1,1,1,1,1,1,1,1,1
